12312313212
01000000010
00100000100
00010001000
00001010000
00000100000
00001010000
00010001000
0010iii0100
01000000010
1s1s1s1s1s1