222222222
1111i1111
000111000
000000000
000000000