2222i2222
2222s2222
000111000
000000000
000000000