1211i1121
111111111
000000000
000000000
000000000