2222i2222
2222s2222
1111s1111
111111111
000000000