1111ii111
111111111
000000000
202020202
s00s00s00