2222i2222
222sss222
222222222
221sss122
000000000