2222i2222
222sss222
1122s2211
111111111
000000000