000010000
000111000
001111110
111111111
000111000
000111000