222222222
222ss2222
22s222s22
222222222
2222s2222